0;0;30;1
12;7;16;1
11;8;15;1
14;11;19;1
12;9;19;1
11;11;20;1
13;8;17;1
12;7;16;1
12;11;18;1
10;9;19;1
13;3;10;1
14;4;14;1
11;3;12;1
13;8;15;1
13;8;16;1
11;8;16;1
13;11;11;1
