0;0;30;1
16;6;16;1
3;9;9;8
13;6;17;1
14;13;21;1
8;23;23;8
4;21;29;1
14;7;15;1
14;2;9;1
14;5;13;1
11;11;18;1
12;17;25;1
14;2;12;1
5;10;10;8
8;15;23;1
4;6;6;8
8;11;11;8
2;9;16;1
12;16;23;1
15;8;17;1
16;14;14;1
